111111111111
1000000C0001
1P000000E011
111111111111
