1111111111111111111111111111111111111111111111111111111
1000000C00000000000000000000000000000C00000000000000011
1P000000E01110000000000000000000000000000000000C0000011
1111111111111111111111111111111111111111111111111111111
