1111111111111
1000000C00011
1P000000E0111
1111111111111
